Assets\Backgrounds\Castle-Sprites2.png
Assets\Backgrounds\Castle-Sprites2Mask.png
9
8
13 70 56 46 99 0 0 0 0 
23 80 56 45 99 0 0 0 0
13 80 56 47 93 99 0 0 0
23 80 56 46 45 45 99 0 0
13 80 56 47 46 45 93 99 0
14 100 56 47 47 57 58 47 99
13 110 4 5 6 4 7 46 57
14 13 14 15 15 27 17 4 18